filename, language, C++, Makefile, comment, blank, total
BufferCache/BufferBlock.cpp, C++, 6, 0, 3, 2, 11
BufferCache/BufferBlock.h, C++, 13, 0, 3, 5, 21
BufferCache/BufferCache.cpp, C++, 31, 0, 3, 7, 41
BufferCache/BufferCache.h, C++, 20, 0, 3, 12, 35
BufferCache/LRU_list.cpp, C++, 51, 0, 3, 8, 62
BufferCache/LRU_list.h, C++, 19, 0, 3, 13, 35
BufferCache/Update.h, C++, 34, 0, 4, 8, 46
DeviceManager.cpp, C++, 115, 0, 5, 26, 146
DeviceManager.h, C++, 45, 0, 7, 36, 88
DiskDriver/DiskDriver.cpp, C++, 71, 0, 6, 13, 90
DiskDriver/DiskDriver.h, C++, 20, 0, 3, 14, 37
Ext2/Bitmap.cpp, C++, 42, 0, 3, 9, 54
Ext2/Bitmap.h, C++, 15, 0, 3, 11, 29
Ext2/Block.cpp, C++, 41, 0, 3, 8, 52
Ext2/Block.h, C++, 14, 0, 3, 10, 27
Ext2/Ext2.cpp, C++, 99, 0, 11, 23, 133
Ext2/Ext2.h, C++, 40, 0, 3, 28, 71
Ext2/GroupDescriptor.cpp, C++, 1, 0, 3, 2, 6
Ext2/GroupDescriptor.h, C++, 12, 0, 3, 5, 20
Ext2/Inode.cpp, C++, 1, 0, 3, 2, 6
Ext2/Inode.h, C++, 10, 0, 3, 5, 18
Ext2/Item.cpp, C++, 4, 0, 3, 2, 9
Ext2/Item.h, C++, 10, 0, 3, 7, 20
Ext2/SuperBlock.cpp, C++, 1, 0, 3, 2, 6
Ext2/SuperBlock.h, C++, 13, 0, 3, 4, 20
Ext2/Table.cpp, C++, 9, 0, 3, 3, 15
Ext2/Table.h, C++, 11, 0, 3, 7, 21
LogUtil.cpp, C++, 12, 0, 3, 7, 22
LogUtil.h, C++, 11, 0, 3, 9, 23
Manipulate.cpp, C++, 144, 0, 13, 23, 180
Manipulate.h, C++, 39, 0, 3, 31, 73
Path.cpp, C++, 46, 0, 3, 9, 58
Path.h, C++, 18, 0, 3, 13, 34
SplitInst.cpp, C++, 45, 0, 3, 9, 57
SplitInst.h, C++, 18, 0, 3, 11, 32
VFS/BlockRegister.cpp, C++, 1, 0, 3, 2, 6
VFS/BlockRegister.h, C++, 5, 0, 3, 4, 12
VFS/DirectoryCache.cpp, C++, 1, 0, 3, 2, 6
VFS/DirectoryCache.h, C++, 5, 0, 3, 4, 12
VFS/InodeCache.cpp, C++, 1, 0, 3, 2, 6
VFS/InodeCache.h, C++, 5, 0, 3, 5, 13
VFS/InodeLinkList.cpp, C++, 1, 0, 3, 2, 6
VFS/InodeLinkList.h, C++, 9, 0, 3, 5, 17
VFS/VFS.cpp, C++, 118, 0, 3, 26, 147
VFS/VFS.h, C++, 28, 0, 3, 22, 53
define.h, C++, 154, 0, 9, 31, 194
display.cpp, C++, 4, 0, 3, 3, 10
display.h, C++, 8, 0, 3, 6, 17
main.cpp, C++, 27, 0, 0, 9, 36
makefile, Makefile, 0, 2, 0, 1, 3
Total, -, 1448, 2, 178, 508, 2136